11111111111111111111111111
1P0000000000000000000000E1
10111C11011C111C1001C11101
10101011111010101101010001
10111010101010101011010101
10101C10001C111C1001C11101
10000000000000000000000001
11111111111111111111111111
