111111
1P0001
1111C1
1E0001
111111