11111111111111111111
1P0000111111000000E1
1000001C000100000001
10000011110100000001
10000000000000000001
11111111111111111111
