11111111111111111111
1P0100111111C00000E1
1001001C00C100010001
1000001111010000C001
11111000000000C00001
11111111111111111111
