11111111111111111111
1P0100111111C00000E1
1001001C00C100000001
10000011110100000001
11111000000000000001
11111111111111111111
