11111111111111111111
1P0000111111C00000E1
1000001000C100000001
10000011110100000001
1C000000000000000001
11111111111111111110
