11111111111111111111
1P0000111111C0000001
1000001000E100000001
10000011111100000001
1C000000000000000001
11111111111111111111
